boy	girl	book
flower	company	world
government	chicken	fish
nightmare	sushi	pizza
revolution	weather	people
mouse	tiger	cat
dog	god	cake
school	sun	family
information	night	money
teacher	astronaut	student
water	manager	food
room	car	bus
story	crisis	idea
opportunity	banana	apple
moon	president	friend
door	minister	window
war	wine	mother
society	history	police
price	game	father
sky	student	health
bird	decision	mind
paper	bank	plan